	а
	ө
	о
	э
	е
ӣ	и
ӯ	у
	О
	А
\n	 
Һ	Х
һ	х
ньа	ня
Ньа	Ня
ньу	ню
Ньу	Ню
ньи	ни	# плохо, что есть ни и ньи (но только в кньилибэн, ньирилан, һньилкан, кэньилил, кэньилив)
ньо	нё
ньэ	не
ньө	нӫ
Ньө	Нӫ
ньӫ	нӫ	# (ньӫлтым, ньөчэл, нӫлтин(1)) - в чём разница между ньӫ, ньө, нӫ? По словарю это НӪЛТЭМ (солнце), НӪЧЭЛ (растения), НӪЛТЭН (первое слово в слове "восток", то есть солнце)
Дьӫ	дӫ
дьӫ	дӫ  # просто дӫ не было
дьэ	де  # просто де было в Эдем, колодехан, колодец, неделяду, неделэ
Дьэ	Де
ди	ды  # просто ды было в урилдывун, адыкундук, ӈэрилдывылбу, нодыврин
дьи	ди  # в словаре именно так дигис>дыгис
дьа	дя
дьу	дю
Дьу	Дю
дьо	дё
йа	я
Йа	Я
йэ	е
йо	ё
йу	ю
бөй	бэй
Бөй	Бэй
бөю	бэю
бөӫ	бэӫ

----
хуйэмкэндэтнэ читается как янкэндэтнэ
ӈэриндэн читается ӈяриндэн
ө не меняю
Подумать: ноӈорбутнон, человек
Меняла с на х при произнесении х (в глаголе быть она произносит то х, то с)
